 ___                           ___    __ __      
/\_ \                         /\_ \  /\ \\ \     
\//\ \      __   __  __     __\//\ \ \ \ \\ \    
  \ \ \   /'__`\/\ \/\ \  /'__`\\ \ \ \ \ \\ \_  
   \_\ \_/\  __/\ \ \_/ |/\  __/ \_\ \_\ \__ ,__\
   /\____\ \____\\ \___/ \ \____\/\____\\/_/\_\_/
   \/____/\/____/ \/__/   \/____/\/____/   \/_/  

Welcome to LEVEL4 of the HackUS CTF Final!!!

Hint :

Submit : ./ask-god -c ctff04 "YOUR_STRING"
